###############
#...........#.#
#..#......#...#
#..#.......####
#..#..........#
#..#..........#
#..#..........#
#..#..........#
#..#..........#
#..#..........#
##.#.......##.#
#..##.....#...#
##........###.#
#..#.........p#
###############