#m#...##.m
#.#.#..#.#
@...##...#
.###.m#.#.
.....##.#.
##.#.##...
.###.#m##.
...#.#..#.
m#...##.#e
####....##