############
##m#...##.m#
##.#.#..#.##
ip...##...##
#.###.m#.#.#
#.....##.#.#
###.#.##...#
#.###.#m##.#
#...#.#..#.#
#m#...##.#.e
#####....###
############