#########################################################
#ooom.o..o.........................mooom................#
#....ooo.o.o###.##.##.#o##o#o#.######.#ooo#.###.###.###.#
#.oo..........#..o......o.o....o....#.#####...#.#...#.#.#
#.##..#.###.#.#.oo..#.o.....#ooo..#.#.####o.###.###.#.#.#
#.###.#.o...#.#..o..#..oo.#o#...###.#.####o.............#
#.oo..#.oo.o#...##oo#o#.#m#ooo#.###.#o#########.#....####
#.o##.o..###..#..#......#o..#..........o....#....###....#
#..o..o......o#o.########.o.#.#.###o#..oooo.#..#.....##.#
#..oooo.###oo..#.##o.o##o.#.#...#oo.#.o.....##.#..###...#
#...ooo.....oo...#o.......#.#.#.#...#.o###.o##........#.#
#.o..oo.##.##o#######o.o###.#oooo.o...o....o#####..#.##.#
#.oo.oo.....#.o..#..#...#.#.#oooo.o.o.oooo.###..........#
#.oo.#...o##o.##.#.#..#.#...........o.oooo.....###.oo...#
#o.o.#..oooo..#..#.o.#m.o.#.#.##.o..o.o....ooo.....#.ooo#
#....#..ooo#..##.#.o.#.o..#.#.##.oo..o.ooooo.o.o.#.#....#
#o..#..#.##..#mo.#...#...##o#....o.o.o...o....o..#.##.#.#
#o..#..#.#..##.o.##########o####oo.o...oo..##o.#.#...#..#
#..oo#o#.....#...o.........o.......ooo..o.#..o.#oo.o.#..#
#.o..o...###...oo.o.o.oo..#.#ooooo.o.o.o..#.o....o.o.#.o#
#..o.o.o.#...oo...o.ooo.oo....o.oo.o.o.o.o..o.o.o...o#..#
#o.o...o.#.oom.o.o...o......o.o.o......o.o....o...o.o##.#
#..oo.o.m.o....o...oo..oo.o.o...ooo.oo...o.o.oo.oo...#..#
#.#...o###.ooo.ooo.o.o.o..o.ooooo...o...o.o...o..o.oo...#
#.#.oo......o..o.o.o...oo.o.....o.o...o.....o..o...o#.###
#....oo.#.o.oo.o.o..o#.....####.#.o#oooo...o.o..o.o.#...#
#.#.o.o.#ooooo...oo.oo.o.o......#..##oooooo.o..o..o...o.#
#.#o....#oooo..o#oo.oo.o.oo#..#.oo..#.......o.##.##o.o..#
#.###..o..o.......o.ooo...o.##o.o##.#ooo#....o.#.#.....##
#...#.ooo.o.#oooo...oo..o##..oo.o##.#ooo..#.#..#.#.o#o..#
#o..#.o...oo...o.o#.oo.o...#....##o...mo.o#.#..#.#..###.#
#.#.#.o.o.o..o.o.oo.o...#...##o...##o######....#.##...#.#
#.#...#.o...oo.o.oo...#.#..#....o...#.......##.#.##.#...#
#.#.##o.oooo.o...##o.#...#...##..oo..#.#######.#.#..#..##
#....#.....o.o.#...##..#...#..##..o.o.#..o..........#o.##
####.#.###.......o....o###.#...#............#.##.####o.m#
##o#.#.#########o#######ooo##############oo#####.#####.o#
##o.....####.....o##.ooo...oo.o...###...o...o..o...o.o..#
##o##.#..##..####.......##..o...#........#.#........o.o.#
##o.....#...o......o.o.o.#o..oo..o.o.o.o.o.o.oo..o.o..o.#
#o..##.ooo.#..oo##o.o......#...o..o#.oo..#.#..o...#o#...#
#o.#..o.o....o.....o.o..o...ooo#.#....#......#oo....##..#
#....##.#..o#..###.....#..#.#......#.o.###.#.#o.ooo...#.#
#.#.#...##o.#.#...#.o.#.##..#.##.#.#.o.....#..o..o..o...#
#.###.o....##...o.o###o.##.o.#.#.#o#..o.###o.o.#..####..#
#.....##.##...#.#...................###..........#......#
###oo....#..o###o.ooooo.oo.o#o.#..o....o.##.o..ooo..o.oo#
###..o..o..##.............#...oo.o.#o.oo..o..oo#.#.o#omo#
###.o.o.o.ooo.#ooo###oo.o.o.o.#o#..o....#..#oo#o.#.o##..#
##o.....o..o#...o...o.o.#...o..o..o#o.o.o..oo.o.....o.o.#
##...o#.#.o...o.#.##o.o#..#..oo..o...o..oo..o....oooo.o.#
####...##.#m#...o.##o.#..o..oo..om.o.oo.o..o.oo..o..#.o.#
##...o..#..#.#.#o.#...#o.oo.o..o.o.ooo....oo..oo..o.....#
##..o##o..oo....#.oo.#........o....o....o.....o...o.oooo#
#.#....#.o..o##.#.o..##.oo.o.oo.oo.o.oo.oo.ooo....o.oo..#
#...o..o..o..o..#...o.....o...o..o...o.oo.o....o##.....o#
#.o.....#...#o.o#.##.###o...o#...o.o......o.o...o.oo.#o.#
#o.o..#.o.o.#...o.......o.o.#...o..oo.o.oo...oo......o..#
#...o...#.o##.#.o.##.##...o...#..o..mo..o..o.....o..o..o#
#.o.ooo.#..#o.#.o.##...#.o.#.##.o.ooo.o...ooo#oo..o.o.oo#
#.o...o.#o.o....#....#...oo..#..#..oo..o..oo.o..oo..o...#
#...#o..#...###..o.#..oo...o#..#.#...#..o.o..oo.#.o..o.o#
#.##...#o.oo...#.#.#.##..o....o#.#.#.o..#..#....o..o...o#
#.....#o#..o.#..........o..oo..#.#.#.o.#.#.#o#.o.#..o...#
#o.#.#....oo.#.##.#.##o.o..o..o.#..#o..o.#.#...o.oo...o.#
#..#.o.oo.o.##..#.#.#....o.o.o..##.o..#..#........o.#.###
#o...o..o.#....o#.o...o....o.......oo.#.#.#.#...##..#...#
#..o..o..##o.##.#.#oo..##.##.o.o......#.#.#.#.###...#oo.#
#.##..o.m##.....#.#...#......o..###o##............o.#.o.#
#.##..o.#...#####.#####.##.##.#........o.oo.####.#o.#.o.#
#m##.mo.#.#......p......o.......o...ooo....o.....#...om.#
#######e#########i#######################################
