###########################
#...oo..##...##om.###o...##
#.#.#..##.##..#o.#...o.#.##
#.#m##.....##.#o.#.#.o.#..e
#..##..###....#o...#.o.#oo#
##........oooooo####.o.##m#
###.#####.#.#.#.#....o.#..#
#...#oooo.#.#.#.#.####.#..#
#.#.#oooo...........#..##.#
p.#.ooo#####.#####..#.o...#
#.##.......m#...#..#m.o.###
#.#o.###.#oo##.#...##.o...#
#..o.##..#.......##....#.o#
##.o....###.#####.#.####..#
#....oooo##.#.m#.....o...o#
#o..#.......#.##.##.#m#o.o#
#o.#..oooooo.....#..#.#..o#
#o.#.#######.####.o.#..#.o#
#..#.........o..#.o..#.#.o#
#.######..###..#.....#....#
#.#....###.....#.###.###..#
#.#m###...#.##.#..oo..#.o.#
#.#.........oo.#o..m#.#.#.#
#.#.########.#.####..##.#.#
#.........#.m......#....#.#
#oooooooo.###.ooooooooo...#
###########################
